Okay, keep it straight.	Tốt, giữ cho nó đi thẳng.
You are not gonna do that.	Em sẽ không làm vậy.
The question I get most frequently is: How do you make something go viral?	Câu hỏi tôi thường xuyên nhận được là: Làm sao bạn làm được thứ được lan truyền đến vậy?
I love the cars, they're dope.	Tôi yêu những chiếc xe, chúng thật kích thích.
CLOSE to a million people were baptized by Jehovah’s Witnesses in the last three years.	NHÂN CHỨNG Giê-hô-va đã làm báp têm cho gần một triệu người trong ba năm qua.
What in the world are you going to do there?"	Bạn có thể làm được gì ở đó cơ chứ?"
One compliment, and now you're coasting.	Một lời khen, và bây giờ cậu đang xuống dốc.
You look like trash, all marked up like that.	Con y như đồ rác rưởi, xăm đầy mình như vậy.
What happened?	Chuyện gì đã xảy ra vậy?
For example, let’s say the currency used for your manager account is US dollars (USD), but one of your managed accounts uses the British pound (GBP).	Ví dụ: giả sử đơn vị tiền tệ được sử dụng cho tài khoản người quản lý của bạn là đô la Mỹ (USD), nhưng một trong những tài khoản được quản lý của bạn sử dụng bảng Anh (GBP).
+ When Saul saw any strong or courageous man, he would recruit him into his service.	+ Khi Sau-lơ thấy bất kỳ ai mạnh mẽ hay can đảm, ông liền chiêu mộ để phục vụ mình.
Over the centuries many wise men and women—through logic, reason, scientific inquiry, and, yes, through inspiration—have discovered truth.	Qua nhiều thế kỷ, nhiều người nam và người nữ khôn ngoan---qua tính hợp lý, lý luận, việc tìm hiểu bằng khoa học, và vâng, cả sự soi dẫn nữa---đã khám phá ra lẽ thật.
That same year, special pioneers came from Portugal.	Cùng năm ấy, các tiên phong đặc biệt ở Bồ Đào Nha bắt đầu đến giúp.
90 And he who feeds you, or clothes you, or gives you money, shall in nowise alose his reward.	90 Và kẻ nào cho các ngươi thức ăn, hay cho các ngươi quần áo mặc, hoặc cho các ngươi tiền, thì sẽ chẳng vì lý do gì bị amất phần thưởng của mình.
(Isaiah 30:21; Matthew 24:45-47) Gilead School helped the graduates to grow in appreciation for that slave class.	(Ê-sai 30:21; Ma-thi-ơ 24:45-47) Trường Ga-la-át giúp các học viên gia tăng lòng biết ơn đối với lớp “đầy-tớ”.
A tree that can bend with the wind is more likely to survive a storm.	Một cái cây có thể cong lại trước cơn gió thì dễ sống sót hơn khi gặp bão.
I think he had some pretty good leads, which could have blown his career wide open... it was great.	Tôi nghĩ anh ấy có vài đầu mối khá tốt, mà có thể làm nghề nghiệp của anh ấy phát triển hơn... nó thật tuyệt.
Touch it!	Để tay vào đi.
And on the y-axis is the loudness of average ambient noise in the deep ocean by frequency.	Trên trục tung là độ to của tiếng ồn trung bình xung quanh các đại dương sâu đo bởi tần số.
Jahre Nebukadnezars II” (An Astronomical Observer’s Text of the 37th Year Nebuchadnezzar II), by Paul V.	Jahre Nebukadnezars II” (An Astronomical Observer’s Text of the 37th Year Nebuchadnezzar II), tác giả Paul V.
How will his mother discipline him?	Người mẹ sẽ sửa dạy con như thế nào?
I can't leave things as they were.	Càng nghĩ càng thấy không thỏa, ta nhất định phải.
(Psalm 25:4) Personal study of the Bible and of the Society’s publications can help you become better acquainted with Jehovah.	Việc học hỏi Kinh-thánh cá nhân và các ấn phẩm của Hội có thể giúp bạn biết rõ Đức Giê-hô-va hơn.
Using sticks isn't the art of combat!	Dùng gậy không phải là nghệ thuật chiến đấu.
An Inclusive & Sustainable Globalization: A Multilateral Approach	Một quá trình Toàn cầu hóa Bền vững Cho mọi người: Cách tiếp cận đa phương
I'll go get help!	Em sẽ tìm giúp đỡ!
They were frustrated, and they had achieved much less than what they had hoped for.	Họ chán nản, và họ không đạt được những gì hi vọng.
Tell Clyde I want my share.	Nói với Clyde em muốn phần của mình.
" We have a witch in the family.	Gia đình ta có một phù thủy.
Song 191 and concluding prayer.	Bài hát 107 và cầu nguyện kết thúc.
As disciples of Jesus Christ, we ought to do all we can to redeem others from suffering and burdens.	Là các môn đồ của Chúa Giê Su Ky Tô, chúng ta phải làm hết sức mình để giúp đỡ những người khác thoát khỏi cảnh khổ đau và gánh nặng.
Happy Thanksgiving!	Happy Thanksgiving!
In the most important area of life —faithfulness to God— Solomon failed.	Trong khía cạnh quan trọng nhất của đời sống, đó là giữ lòng trung thành với Đức Chúa Trời, thì ông lại thất bại.
Is that understood?	Cậu rõ chưa?
There were moments when he would actually space out for seconds at a time.	Đã có những lúc cậu có thể thực sự thoát ra ngoài được vài giây đồng hồ.
So, for Ebola, the paranoid fear of an infectious disease, followed by a few cases transported to wealthy countries, led the global community to come together, and with the work of dedicated vaccine companies, we now have these: Two Ebola vaccines in efficacy trials in the Ebola countries --	Với Ebola sự bấn loạn nó gây ra cùng với việc có 1 số ca lây lan đến các nước phát triển đã khiến cho cộng đồng thế giới gắn kết với nhau cùng với sự nỗ lực của những nhà cung cấp vắc-xin hàng đầu, giờ thì chúng ta có những thứ này: Hai mẫu thử vắc-xin hữu nghiệm ở các quốc gia nhiễm Ebola
Researchers tell us there is a mechanism in our brain called the pleasure center.2 When activated by certain drugs or behaviors, it overpowers the part of our brain that governs our willpower, judgment, logic, and morality.	Các nhà nghiên cứu cho chúng ta biết rằng có một bộ phận trong óc chúng ta được gọi là trung tâm khoái lạc.2 Khi được kích thích bởi vài chất ma túy hoặc hành vi nào đó thì trung tâm này sẽ áp đảo một bộ phận trong óc chúng ta là bộ phận chỉ huy ý chí, cách xét đoán, lý luận và đạo đức.
What math?	Tính chuyện gì?
• How can we show tender regard for aging fellow worshippers?	• Làm thế nào chúng ta có thể biểu lộ lòng quan tâm nhân từ đối với các anh chị cao tuổi?
When we give of ourselves to others, not only do we help them but we also enjoy a measure of happiness and satisfaction that make our own burdens more bearable. —Acts 20:35.	Khi quên mình vì người khác, không những chúng ta giúp họ mà còn cảm thấy hạnh phúc và mãn nguyện ở mức độ nào đó, khiến gánh nặng của chúng ta dễ chịu đựng hơn.—Công-vụ 20:35.
Maybe I should.	Có lẽ tớ nên làm thế thật.
Faith in what?	Đức tin nơi ai?
That's like a particle with mass, because you are connecting, interacting, with that Higgs snow field.	Giống như một hạt với khối lượng, bởi vì bạn kết nối, tương tác, với trường tuyết Higgs.
Kenya is now speeding up.	Kenya cũng tăng tốc.
You know, a good night's sleep wouldn't be the worst thing in the world.	Cô biết đấy, một giấc ngủ ngon và không để tâm tới những thứ tồi tệ đang xảy ra trên trái đất.
Provider of any and all entertainments and diversions.	Người cung cấp tất cả các trò giải trí... và tiêu khiển ở đây.
After we get all this stuff, we go over to Maxwell Street... to get hot dogs from those Polish people here.	Bây giờ chúng ta lo xong chuyện học hành rồi.
The Devices, Assisting Devices, and Device Paths reports show you not only when customers interact with multiple ads before completing a conversion, but also when they do so on multiple devices.	Các báo cáo Thiết bị, Thiết bị hỗ trợ và Đường dẫn thiết bị không chỉ cho bạn thấy thời điểm khách hàng tương tác với nhiều quảng cáo trước khi hoàn thành chuyển đổi mà còn thời điểm họ làm như vậy trên nhiều thiết bị.
That won't matter to Demmin Nass.	Điều đó ko hề gì với Demmin Nass.
13, 14. (a) How does Jehovah demonstrate reasonableness?	13, 14. (a) Đức Giê-hô-va thể hiện tính phải lẽ như thế nào?
He was our responsibility.	Cậu ấy là trách nhiệm của chúng ta.
I have your number.	Tôi có số của cô...
Look out!	Coi chừng!
Do I know you?	Tôi có quen anh sao?
If we could just.... if we could just make this right.	nếu chúng ta chỉ... chỉ có thể sửa chữa lại những điều đó.
However, armed employment exposes one to the possibility of becoming bloodguilty if called upon to use one’s weapon.	Tuy nhiên, việc làm như thế khiến một người có thể mang nợ máu trong trường hợp đòi hỏi phải dùng vũ khí.
I saw that accident too.	em đã chứng kiến vụ tai nạn đó.
We still have an opportunity to not only bring the fish back but to actually get more fish that can feed more people than we currently are now.	Vẫn còn cơ hội để không chỉ mang đàn cá trở lại mà còn đánh bắt được nhiều cá hơn nuôi sống nhiều người hơn so với hiện tại.
(Ephesians 6:1-3) He expects parents to instruct and correct their children.	Đức Chúa Trời đòi hỏi con cái phải vâng lời cha mẹ (Ê-phê-sô 6:1-3).
Jim, I don't know what to tell you.	Jim, Tôi không biết phải nói thế nào
Just one.	Chỉ một.
He needs boundaries and a strong hand.	Nó cần phải có 1 bàn tay mạnh mẽ bảo vệ nó.
And pray for God’s help to develop this elevated kind of love, which is a fruit of God’s holy spirit. —Proverbs 3:5, 6; John 17:3; Galatians 5:22; Hebrews 10:24, 25.	Và cầu nguyện xin Đức Chúa Trời giúp đỡ bạn phát triển loại yêu thương cao thượng này, vì đó là một trái của thánh linh Đức Chúa Trời (Châm-ngôn 3:5, 6; Giăng 17:3; Ga-la-ti 5:22; Hê-bơ-rơ 10:24, 25).
Is that you take this back.	Lấy lại cái này.
And what's good about this, I think, is that it's like a moment in time, like you've turned around, you've got X-ray vision and you've taken a picture with the X-ray camera.	Và quý nhất là 1 khoảnh khắc đúng lúc, khi bạn nhìn xung quanh, lấy được 1 tầm nhìn X-quang và chụp 1 bức bằng camera X-quang.
These are quite different, and they are outside the grasp of modern diplomacy.	Những cuộc xung đột này khá khác nhau, và chúng nằm ngoài tầm hiểu biết của ngoại giao hiện đại.
Not that they were any good, but they were there.	Không phải chúng ngon, mà vì chúng luôn có sẵn.
If we follow this guideline, we will not make the truth more complicated than it needs to be.	Nếu theo sự hướng dẫn này, chúng ta sẽ không làm cho lẽ thật trở nên quá phức tạp.
Why didn't you tell me?	Vậy sao không cho em biết?
And the longer your talk, the simpler it must be made and the stronger and more sharply defined your key points must be.	Bài giảng của bạn càng dài, thì bạn càng phải làm cho thật giản dị và càng phải làm nổi bật rõ ràng các điểm chính.
You will also smile as you remember this verse: “And the King shall answer and say unto them, Verily I say unto you, Inasmuch as ye have done it unto one of the least of these my brethren, ye have done it unto me” (Matthew 25:40).	Các chị em cũng sẽ mỉm cười khi nhớ tới câu này: “Vua sẽ trả lời rằng: Quả thật, ta nói cùng các ngươi, hễ các ngươi đã làm việc đó cho một người trong những người rất hèn mọn nầy của anh em ta, ấy là đã làm cho chính mình ta vậy” (Ma Thi Ơ 25:40).
Yes, ma'am.	Vâng thưa cô.
Casey has a map.	Casey có bản đồ.
That's right.	Chính xác.
Stand still, idiot.	Đứng yên, đồ ngu.
If your men are smart, they'll take care of you themselves.	Nếu người của mày thông minh, thì họ sẽ tự xử mày.
In anticipation of the new ruling , 30,000 new vehicles were registered in the past week , at least three times the normal rate , Xinhua state news agency .	Để đề phòng luật mới , 30.000 xe mới đã đăng ký vào tuần trước , ít nhất là bằng ba lần tỷ lệ bình thường , hãng tin nhà nước Xinhua .
Such phrases can help you better understand and focus on the main ideas and principles in the scriptures.	Các cụm từ như vậy có thể giúp các em hiểu rõ hơn và tập trung vào những ý chính và các nguyên tắc trong thánh thư.
Thus, Jesus and his apostles taught that he was “the Son of God,” but it was later churchmen who developed the idea of “God the Son.”	Như vậy, Giê-su và các sứ-đồ dạy rằng ngài là “Con của Đức Chúa Trời”, nhưng sau này các nhà thờ bày đặt ra ý-niệm về “Đức Chúa (Trời) Con”.
She must have given it back before she took off on him.	Bà ấy hẳn đã bỏ nó lại trước khi bỏ bố mà đi.
We're gonna watch her, make sure that her pressure doesn't drop again, but, yes, she's going to be okay.	để chắc chắn hơn. cô ấy sẽ ổn thôi.
No, Dr. and Mrs. Cullen yank them out for, like, hiking and camping and stuff.	Ông bà Cullen kéo họ đi bộ, cắm trại và làm những thứ linh tinh khác.
What do you want me to do?	Cậu còn muốn tớ làm gì nữa?
In the last two minutes, no.	Trong hai phút vừa qua thì không.
The prophecy regarding the destruction of Jerusalem clearly portrays Jehovah as a God who ‘causes his people to know new things before they begin to spring up.’ —Isaiah 42:9.	Lời tiên tri về việc thành Giê-ru-sa-lem bị hủy diệt miêu tả rõ ràng Đức Giê-hô-va là Đức Chúa Trời ‘làm cho dân Ngài biết các sự mới trước khi chúng nổ ra’.—Ê-sai 42:9.
We're having a good time.	Chúng ta đang vui vẻ mà.
ATAC has strict rules against employees getting involved with each other.	ATAC cấm nhân viên quan hệ tình cảm với nhau.
Take off your coat!	Mau cởi áo khoác ra.
Intel 's Next Generation Platform to Support GPGPU	Nền tảng thế hệ Chip kế tiếp của Intel sẽ hỗ trợ GPGPU
Manu builds a boat, which the fish pulls until it is grounded on a mountain in the Himalayas.	Manu đóng một chiếc tàu và được con cá kéo cho đến khi chiếc tàu tấp trên một ngọn núi trong dãy Hy Mã Lạp Sơn.
So who's first?	Ai trước nào?
The boy has told us of your needs, and all is waiting for you.	Thằng bé đã nói cho chúng ta những cái con cần, và ta đã chuẩn bị sẵn.
It's a hard problem because the water sloshes about, but it can do it.	Đây là một công việc khó khăn vì nước thường bị bắn tung tóe, nhưng người máy có thể làm việc đó.
So perfect.	Thật hoàn hảo.
They're- - they're ready for you.	Họ đã sẵn sàng để gặp anh rồi.
Once your Google Ads and Salesforce accounts are linked, you need to choose which Salesforce milestones – lead statuses and opportunity stages – to monitor for conversions.	Khi tài khoản Google Ads và Salesforce được liên kết, bạn cần chọn những sự kiện quan trọng, trạng thái khách hàng tiềm năng và giai đoạn cơ hội, để theo dõi dữ liệu chuyển đổi.
Not when I'm on the inside.	Đâu phải khi em đang trong đó.
His club is said to be the hardest among the presidential staff.	Hộp đêm của anh ta là khá nhất trong các hộp đêm
All reds.	Tất cả đều đỏ.
If Lorenzo tucks me in.	Nếu chú Lorenzo đưa cháu vô.
this test will show us.	Nếu có khối u, xét nghiệm sẽ cho ta thấy...
Food, water, shelter, medical care, and emotional and spiritual support are provided as soon as possible	Cung cấp càng sớm càng tốt thức ăn, nước uống, chỗ ở, sự chăm sóc y tế cũng như sự trợ giúp về tinh thần và thiêng liêng
You will be able to declare in simple, straightforward, and profound ways the core beliefs you hold dear as a member of The Church of Jesus Christ of Latter-day Saints.	Các em sẽ có thể tuyên bố trong một cách giản dị, thẳng thắn và sâu sắc về niềm tin cơ bản mà các em quý trọng với tư cách là tín hữu của Giáo Hội Các Thánh Hữu Ngày Sau của Chúa Giê Su Ky Tô.
I think I'm going to be happy with him.	Con nghĩ là ở bên cạnh anh ấy thì con sẽ rất vui.
We are only finding the path we are meant to walk on.	Chúng ta chỉ tìm hướng đi mà chúng ta đã được chọn sẵn để đi.
2 For the building of mine ahouse, and for the laying of the foundation of Zion and for the priesthood, and for the debts of the Presidency of my Church.	2 Để xây dựng angôi nhà của ta, và để đặt nền móng của Si Ôn, và để dùng trong Chức Tư Tế, và để thanh toán các nợ nần của Chủ Tịch Đoàn Giáo Hội của ta.
In some cultures, it is considered poor manners to address a person older than oneself by his first name unless invited to do so by the older one.	Trong một số nền văn hóa, gọi người lớn tuổi hơn bằng tên bị xem là khiếm nhã trừ khi được phép.
With my two children today	Với hai con tôi hiện nay
I suggest you return to your duties and drop this matter.	Tôi đề nghị anh quay lại làm việc của mình và bỏ vụ này đi.
“And this shall ye do in remembrance of my body, which I have shown unto you.	“Và các ngươi làm việc này để tưởng nhớ tới thể xác của ta, mà các ngươi đã được ta cho trông thấy.
Yes, sir.	Vâng thưa ngài.
Many sincere ones have thus heard the good news and have started to study the Bible.	Nhiều người thành thật do đó nghe được tin mừng và đã bắt đầu học hỏi Kinh Thánh.
Excuse me?	Xin lỗi!
My partner and i are trying to transition some of the homeless vets out here into affordable housing.	Cộng sự của tôi và tôi... đang muốn những người vô gia cư được sống tốt hơn
So, do I have to drive down there?	Vậy, tôi phải lái xe tới đó à?
Pick up your gun.	Lượm súng lên đi.
They were studying Korean; they bought Korean clothes.	Họ học tiếng Hàn, mua quần áo Hàn.
For them, Isaiah’s prophecy contained a comforting promise of light and hope —Jehovah would restore them to their homeland!	Đối với họ, lời tiên tri của Ê-sai chứa đựng một lời hứa an ủi về ánh sáng thiêng liêng và hy vọng—Đức Giê-hô-va sẽ đưa họ về quê hương!
It stands to reason that we, existing in this world, should in the course of our lives absorb intuitively those relationships.	Nó đại diện cho lý do chúng ta tồn tại trong thế giới này, đang tồn tại trong đời sống của mình hấp thu một cách trực giác những mối quan hệ đó.
Additionally all data transferred using the Google Ads API must be secured using at least 128 Bit SSL encryption, or for transmissions directly with Google, at least as secure as the protocol being accepted by the Google Ads API servers.	Ngoài ra tất cả các dữ liệu được chuyển bằng cách sử dụng Google Ads API (AdWords API) phải được bảo đảm sử dụng mã hóa SSL tối thiểu 128 Bit hoặc ít nhất là an toàn như giao thức được chấp nhận bởi máy chủ Google Ads API (AdWords API) trong trường hợp truyền trực tiếp tới Google.
18 After you deliver your talk, listen carefully to the oral counsel offered.	18 Sau khi nói bài giảng, bạn nên chăm chú nghe lời khuyên bảo.
And lovingly said: “I want to.”	luôn muốn đưa tay trợ giúp người cầu xin.
“It is a humbling experience to come here and spend time listening to instruction,” Brother Swingle said, adding: “You go away from here much better equipped to magnify Jehovah.”	Anh Swingle nói: “Đến đây và bỏ thời giờ ra nghe giảng là một kinh nghiệm làm bạn khiêm nhường. Khi rời khỏi nơi đây, bạn được trang bị tốt hơn nhiều để đề cao Đức Giê-hô-va”.
He can even see me from there?	Hắn có thể thấy mình ở đây sao?
No one here is allowed to talk to each other	Không được nói chuyện với nhau
Don't trust those men!	Đừng tin những kẻ đó!
And this was "Scared."	Và đây là "Ác mộng."
So we put up a tent on an open piece of ground on the farm of an interested person.	Vì thế chúng tôi dựng lều trên một mảnh đất trống trong nông trại của một người chú ý.
Before you can sign in another person, be sure you've added the second person to your Chromebook.	Trước khi có thể đăng nhập người khác, hãy đảm bảo rằng bạn đã thêm người thứ hai vào Chromebook của mình.
40 You will equip me with strength for the battle;+	40 Ngài trang bị sức cho con ra trận,+
The tundra blazes with color and the whole landscape is transformed.	Cả lãnh nguyên rực rỡ với màu sắc và toàn bộ vùng đất đang được biến đổi.
Always takes my owl, should I wish to register an opinion on the news of the day.	Luôn khoái nghe tôi bình luận tin tức trong ngày
Last night, I realized that I was thinking about your wife's case the wrong way.	tôi nhận ra rằng tôi đã nhầm về vụ của vợ ông.
As it turns out, there actually wasn't any waste paper in this village.	Bởi vì, thật sự không có bất kỳ nguồn giấy thài nào ở ngôi làng.
Do you know where we might find him?	Ông có biết tìm ông ta ở đâu ko?
Praetor.	Pháp quan.
The Kingdom will crush all man-made rulerships and become earth’s sole government.	Nước Trời sẽ đánh tan tất cả sự cai trị do con người lập ra và trở thành chính phủ duy nhất trên đất.
I wonder what else of yours I have.	Con tự hỏi con có gì từ cha mẹ nữa.
However, once a buyer has opted out of disclosing their bid data, this information is excluded for all publishers they transact on.	Tuy nhiên, khi người mua đã chọn không tham gia tiết lộ dữ liệu giá thầu, thông tin này bị loại trừ cho tất cả các nhà xuất bản mà họ giao dịch.
Nathan isn't sure if you have one or not.	Nathan không chắc em có ý thức hay không.
“Although [the deceptive talker] makes his voice gracious,” the Bible warns, “do not believe in him.” —Proverbs 26:24, 25.	Kinh Thánh cảnh giác: “[Dù kẻ phỉnh gạt] nói ngọt-nhạt, thì chớ tin”.—Châm-ngôn 26:24, 25.
Sign my shirt, would you?	Anh ký vào áo tôi, được không?
Big gooberfish!	Cá lớn kìa!
And this enables them to orient in complete darkness.	Và điều này cho phép chúng hoàn toàn định hướng được trong bóng tối.
Meaning, you don't know...	Nghĩa là, cậu không biết...
If you aim for his shirt, you might miss by 2 feet.	Nếu cậu ngắm vào cả chiếc áo, cậu có thể trượt hai thước.
And for some strange reason, I thought of you.	Và vì một lý do kỳ lạ nào đó, con nghĩ tới mẹ.
How can the application of 1 Corinthians 15:33 help us to pursue virtue today?	Ngày nay, việc áp dụng câu Kinh-thánh ở I Cô-rinh-tô 15:33 có thể giúp chúng ta theo đuổi con đường đạo đức như thế nào?
Now, that may sound judgmental, but it's not meant to be.	Điều đó có vẻ đầy phán xét, nhưng hàm ý thì không như vậy.
That's your plan?	Kế hoạch là như vậy à?
This may include gathering fast offerings, caring for the poor and needy, caring for the meetinghouse and grounds, serving as a messenger for the bishop in Church meetings, and fulfilling other assignments from the quorum president.	Điều này có thể gồm có việc thu góp của lễ nhịn ăn, chăm sóc người nghèo khó và túng thiếu, trông nom nhà hội và khuôn viên nhà hội, phục vụ với tư cách là người đưa tin cho vị giám trợ trong các buổi họp Giáo Hội và làm tròn các công việc chỉ định khác từ chủ tịch nhóm túc số.
A woman gains a testimony of temple ordinances.	Một phụ nữ đạt được một chứng ngôn về các giáo lễ đền thờ.
So a pope cannot be lecherous, Cardinal, in public or in private?	Vậy Giáo Hoàng không được dâm đãng à, Giáo chủ, dù công khai hay thầm kín?
That their parents be less tired and less stressed.	Là cha mẹ chúng bớt mệt mỏi và căng thẳng.
People worry that there won't be enough food, but we know, if we just ate less meat and fed less of the crops to animals, there is enough food for everybody as long as we think of ourselves as one group of people.	Mọi người lo lắng rằng sẽ không đủ thực phẩm, nhưng chúng ta biết, nếu chúng ta ăn ít thịt hơn và cho động vật ăn ít hơn các loại cây trồng. nó sẽ đủ thực phẩm cho tất cả mọi người miễn là chúng ta nghĩ về bản thân mình cùng là một nhóm người
♪ All babies together... ♪ Our super pigs will not only be big and beautiful, they will also leave a minimal footprint on the environment, consume less feed and produce less excretions.	Những con siêu lợn này không chỉ to đẹp, chúng sẽ gây ít tác động tới môi trường, ăn ít hơn và thải ít hơn.
Actually, from day to day he perceived things with less and less clarity, even those a short distance away: the hospital across the street, the all- too- frequent sight of which he had previously cursed, was not visible at all any more, and if he had not been precisely aware that he lived in the quiet but completely urban Charlotte Street, he could have believed that from his window he was peering out at a featureless wasteland, in which the grey heaven and the grey earth had merged and were indistinguishable.	Trên thực tế, từ ngày này sang ngày khác, ông cảm nhận mọi thứ một cách rõ ràng ít hơn và ít hơn, thậm chí những khoảng cách ngắn đi: các bệnh viện trên đường phố, tất cả các quá thường xuyên nhìn thấy mà ông trước đó đã bị nguyền rủa, không thể nhìn thấy nữa, và nếu anh ta không nhận thức được một cách chính xác rằng ông sống trong Charlotte phố yên tĩnh nhưng hoàn toàn đô thị, ông có thể tin rằng từ cửa sổ của mình, ông nhìn chăm chú ra tại một không đặc biệt đất hoang, trong đó trời màu xám và đất xám đã sáp nhập và không thể phân biệt.
They work for longer hours with less income, less social welfare.	Họ làm việc nhiều giờ hơn với ít thu nhập hơn, ít phúc lợi xã hội hơn.
Different prophets in different times warned us of another tragedy that is less perceptible but not less important, and this is the “awful death [that] cometh upon the wicked; for they die as to things pertaining to things of righteousness; for they are unclean, and no unclean thing can inherit the kingdom of God” (Alma 40:26).	Các vị tiên tri khác trong những thời điểm khác đã cảnh cáo chúng ta về một thảm cảnh khác khó nhận thấy hơn nhưng không kém quan trọng, và đây là “cái chết ghê gớm đến với kẻ độc ác; vì họ chết đối với những điều thuộc sự ngay chính; vì họ ô uế, và không một vật ô uế nào có thể thừa hưởng được vương quốc của Thượng Đế” (An Ma 40:26).
Although it 's a near-perfect measure of the entire U.S. market , the Wilshire 5000 is referred to less often than the less comprehensive SP 500 when people talk about the entire market .	Mặc dù nó là một thước đo gần như hoàn hảo của toàn thị trường Mỹ , nhưng chỉ số Wilshire 5000 ít được đề cập đến so với chỉ số SP 500 vốn mang tính tổng hợp thấp khi người ta nói về toàn thị trường .
I've seen young men suffering from mental illness, unable to ask for help, for fear it would make them less of a men -- or less of a man.	Tôi thấy nhiềungười đàn ông trẻ đang phải chịu những áp lực về tinh thần, họ không thể nhờ giúp đỡ, vì họ sợ sẽ trông kém nam tính hơn. hoặc là trông không giống như đàn ông thường làm
In fact, suffering is so huge and enormous, his own becomes less and less monumental.	Thật ra, đau khổ quá to lớn nên nỗi đau khổ của ngài càng ít quan trọng hơn.
But does that make the Scriptures less valuable, less important?	Có phải vì vậy mà Kinh Thánh không còn quý như trước, hoặc kém quan trọng hơn không?
You're often charged less -- sometimes much less -- than your maximum cost-per-click (max. CPC) bid, which is the most you'll typically be charged for a click.	Thông thường, bạn chỉ phải trả số tiền thấp hơn -- đôi khi là thấp hơn rất nhiều -- giá thầu theo giá mỗi nhấp chuột tối đa (CPC tối đa), là số tiền cao nhất bạn sẽ bị tính phí cho một nhấp chuột.
And that isn't true -- when you get less miserable, you get less miserable.	Điều này không đúng - khi bạn ít đau khổ hơn, bạn ít đau khổ hơn.
This would allow you to bid more for these customers if you find that they’re especially valuable to your business, or less if you find that they’re less likely to convert.	Điều này sẽ cho phép bạn đặt giá thầu cao hơn cho những khách hàng này nếu bạn thấy rằng họ đặc biệt có giá trị với doanh nghiệp của mình hoặc đặt giá thầu thấp hơn nếu bạn thấy rằng họ có ít khả năng chuyển đổi.
So office sound is a huge area, and incidentally, noise in offices has been shown to make people less helpful, less enjoy their teamwork, and less productive at work.	Nên âm thanh trong văn phòng là một lĩnh vực lớn, và nhân tiện, tiếng ồn ở văn phòng khiến mọi người ít giúp đỡ, ít thấy thích thú với làm việc nhóm hơn, và làm việc ít hiệu quả hơn.
And second of all, it turns out this algorithm is actually less efficient. When we talk about how to do modular exponentiations -- we're gonna do that in the last segment in this module -- you'll see that the running time to compute this exponentiation is actually cubic in the size of P. So this will take roughly log cube of P, whereas if you remember, Euclid's algorithm was able to compute the inverse in quadratic time in the representation of P. So not only is this algorithm less general it only works for primes, it's also less efficient. So score one for Euclid.	Euclid thì khác, cũng làm việc với modulo là hợp số thứ hai, thuật toán này ít hiệu quả hơn khi ta nói về thuật toán tính lũy thừa theo modulo ở phần cuối của video bạn sẽ thấy thời gian chạy của nó sẽ là lập phương chiều dài của p hay cách khác là log của P lập phương thuật toán của Euclid thì lại có thể tính nghịch đảo trong thời gian tỉ lệ với bình phương chiều dài của p thế là thuật toán mới này vừa ít tổng quát hơn và cũng kém hiệu quả hơn so với Euclid.
Mothers who know are willing to live on less and consume less of the world’s goods in order to spend more time with their children—more time eating together, more time working together, more time reading together, more time talking, laughing, singing, and exemplifying.	Những người mẹ hiểu biết đều sẵn lòng sống thiếu hụt và tiêu dùng ít hơn những của cải của thế gian để dành thời giờ nhiều hơn cho con cái của họ—nhiều thời giờ hơn để cùng ăn chung, cùng làm việc, cùng đọc sách, cùng nói chuyện, cười đùa, ca hát và nêu gương.
In time, the Walshes became convinced of what Tyndale was saying, and the clergymen were invited less often and were received with less enthusiasm.	Với thời gian, ông bà Walsh dần dần tin nơi những gì Tyndale nói, và các tu sĩ ít khi được mời đến nhà nữa và không được đón tiếp niềm nở như xưa.
I think it's important that we don't just get on this freeway to ICU without thinking hard about whether or not that's where we all want to end up, particularly as we become older and increasingly frail and ICU has less and less and less to offer us.	Tôi nghĩ điều quan trọng là chúng ta không chỉ chọn con đường cao tốc này tiến thẳng đến ICU mà không nghĩ kỹ về việc liệu đó có phải là kết cục mà chúng ta cuối cùng muốn hướng tới hay không, cụ thể là khi chúng ta già đi và suy nhược ngày càng tăng và ICU ngày càng không giúp gì cho chúng ta được nữa
Others claim, ‘The less you know, the less is expected of you.’	Những người khác cho rằng “nếu biết ít thì không bị đòi hỏi phải làm nhiều”.
Less and less.	Càng ngày càng ít.
However, as we get richer, each extra dollar of GDP is buying us less and less social progress.	Tuy nhiên , chúng ta càng giàu lên , thì những đồng đôla thêm vào trong GDP lại càng khiến chúng ta rời xa hơn với tiến bộ xã hội
And with more and more of the world's population living on this part of the curve, it means GDP is becoming less and less useful as a guide to our development.	Và với càng nhiều dân số thế giới sống ở phần này của đường cong, nó có nghĩa là GDP đang trở nên ít hiệu quả hơn với vai trò dẫn ta đến sự phát triển.
The more stress, the less brain development, which in turn causes less adaptability and causes higher stress levels.	Càng stress, não càng không phát triển dẫn đến càng ít khả năng thích nghi và gây ra stress ở mức cao hơn.
Individuals would be less demanding, family members less quarrelsome, corporations less competitive, and nations less belligerent.	Người ta sẽ ít đòi hỏi hơn, những thành viên trong gia đình bớt sinh sự cãi nhau, các công ty bớt cạnh tranh và các quốc gia bớt gây chiến hơn.
I started traveling less, doing less, using less.	Tôi bắt đầu đi ít hơn, làm việc, sử dụng ít hơn.
To grownups , more meaningful means slowing down , spending less money , and worrying less about buying tons of expensive gifts for everyone .	Đối với người lớn thì việc có ý nghĩa hơn đồng nghĩa với hoạt động chậm lại , tốn kém ít hơn , và không phải bận tâm nhiều về việc mua nhiều quà tặng đắt tiền cho hết thảy mọi người .
We don’t discover humility by thinking less of ourselves; we discover humility by thinking less about ourselves.	Chúng ta không khám phá ra lòng khiêm nhường bằng cách nghĩ mình là thấp kém; chúng ta khám phá ra lòng khiêm nhường bằng cách nghĩ ít về mình hơn.
Talk less, laugh less	Nói ít, cười ít.
From field studies to laboratory studies, we see that winning or losing an election, gaining or losing a romantic partner, getting or not getting a promotion, passing or not passing a college test, on and on, have far less impact, less intensity and much less duration than people expect them to have.	Từ các nghiên cứu thực địa cho đến những nghiên cứu trong phòng thí nghiệm, chúng ta thấy rằng thắng hay thua một cuộc bầu cử, có được hay bị mất đi người yêu, được hoặc không được thăng chức, đỗ hay trượt một kì thi đại học, v.v., có tác động, cường độ và đặc biệt là thời gian diễn ra ít hơn rất nhiều so với chúng ta nghĩ.
But, if the merit idea was true, why would identical resumes, in an experiment done in 2012 by Yale, identical resumes sent out for a lab technician, why would Jennifers be deemed less competent, be less likely to be offered the job, and be paid less than Johns.	Nhưng nếu khái niệm thành quả đó đúng, tại sao nghiên cứu của Yale năm 2012 cho thấy trong những bộ hồ sơ giống nhau cho vị trí kỹ thuật viên phòng lab tại sao hồ sơ của Jennifers lại có vẻ thiếu tính cạnh tranh lại ít có khả năng được chọn, và được trả lương ít hơn Johns?
Statistically, those who have less education and consequently lower incomes are less likely to marry and to go to church and much more likely to be involved in crime and to have children outside of marriage.	Theo thống kê, những người ít học thức và do đó có thu nhập thấp hơn thì có lẽ ít kết hôn cũng như ít đi nhà thờ hơn và có lẽ dính líu đến tội ác và có con cái bên ngoài vòng hôn nhân nhiều hơn.
Youth often have less experience with the gospel and may feel less comfortable making comments in class.	Giới trẻ thường có ít kinh nghiệm hơn với phúc âm và có thể cảm thấy ít thoải mái hơn khi đưa ra ý kiến trong lớp học.
The less we emit, the less that sum will be of CO2, and, therefore, the less the temperature.	Chúng ta càng thải ra ít, lượng CO2 càng ít, và, vì vậy, nhiệt độ càng ít tăng lên.
You know, I'm beginning to like the younger gray less and less.	Tôi bắn đầu thích ông già tóc bạc thời trẻ chút chút rồi.
What I'm saying is, we should be less quick to decide that that change is terrible, we should be less quick to impose our likes and dislikes about words on other people, and we should be entirely reluctant to think that the English language is in trouble.	Điều tôi muốn nói là, chúng ta chớ nên nhanh quá khi quả quyết rằng thay đổi đó là quá đáng, hãy chậm áp đặt việc ta thích hay không thích những từ người khác đang dùng, ta nên dè dặt càng hơn khi nghĩ rằng Tiếng Anh đang gặp nạn.
IUDs with less copper will be less effective.”	Dụng cụ chứa ít đồng hơn thì hiệu quả sẽ kém hơn”.
Day after day he was bringing less and less trees .	Ngày qua ngày anh ta mang về số cây càng lúc càng ít đi .
As human governments near their end, we can expect them to become less and less tolerant of our neutral stand.	Khi các hệ thống chính trị của con người sắp đi đến hồi kết, chúng ta sẽ không ngạc nhiên nếu họ ngày càng khó chấp nhận lập trường trung lập của chúng ta.
Almost all babies born at 30 weeks or less will experience apnea , but apnea spells become less frequent with age .	hầu hết tất cả các trẻ sinh ở tuần thứ 30 trở xuống đều sẽ bị bệnh này , nhưng các cơn bệnh trở nên ít đi khi trẻ lớn lên .
And instead of him saying, "OK, Evelyn, please, feet slightly apart, arms at a more or less 90-degree angle, sticks in a more or less V shape, keep this amount of space here, etc.	Nhưng thầy tôi lại nói, " Được rồi, Evelyn, hãy dang hai chân ra, đưa tay lên một góc khoản 90 độ, những cái que tạo thành hình chữ V, và giữ nó như vậy.
People are less and less interested in the welfare of others, in some cases even in that of members of their own family.	Người ta ngày càng ít quan tâm đến hạnh phúc của người khác, dù đôi khi là của chính người thân mình.
And furthermore, our project was less and less in the focus of the management, because they started to think about new projects, restructuring and so on.	Và hơn nữa, dự án chúng tôi càng ngày càng ít nằm trong sự tập trung của công ty, vì họ bắt đầu nghĩ về những dự án mới, tổ chức lại và như vậy.
On the other hand was my grandmother, who also took care of me and was more spiritual, less educated and definitely less rational.	Còn một mặt là bà tôi, người cũng chăm sóc tôi bà mê tín hơn, ít học hơn và dĩ nhiên là ít lý trí hơn.
You will need that strength because it will become less and less popular to be a Latter-day Saint.	Các em sẽ cần đến sức mạnh đó vì việc làm một Thánh Hữu Ngày Sau sẽ càng ngày càng trở nên ít được ưa thích.
Yet, as each climbs higher and higher toward the narrow summit, the distance between them becomes less and less.	Nhưng khi mỗi người càng lúc càng leo lên gần đỉnh núi, khoảng cách giữa họ càng lúc càng nhỏ hơn.
And the people who love Legos less would build less Legos because the enjoyment that they derive from it is lower.	Và những người ít yêu thích Lego hơn sẽ lắp ráp ít hơn bởi vì niềm yêu thích họ nhận được ít hơn.
For example, planes require more runway for takeoff because the heated, less dense air, provides for less lift.	Ví dụ, những chiếc máy bay cần đường băng rộng hơn để cất cánh vì không khí càng nóng và nhẹ thì sẽ càng làm cho sức nâng của máy bay kém đi.
Based on our analysis, teams in these organizations spend between 40 and 80 percent of their time wasting their time, but working harder and harder, longer and longer, on less and less value-adding activities.	Theo phân tích của chúng tôi, các đội nhóm trong những tổ chức này dành từ 40-80% thời gian của họ cho những việc không đâu. Tuy làm việc ngày càng chăm chỉ hơn, lâu hơn nhưng những giá trị lao động họ tạo ra ngày càng ít.
By applying a strict process, we give them less control, less choice, but we enable more and richer social interactions.	Bằng việc thực hiện một quá trình nghiêm ngặt, chúng tôi trao ít quyền kiểm soát và ít lựa chọn hơn cho họ, nhưng chúng tôi lại tạo ra cho họ nhiều tương tác xã hội hơn.
But it doesn't mean that I am any less committed... or try any less hard for my son.	Nhưng không có nghĩa là rằng tôi ít hứa hẹn hơn... hay ít cố gắng hơn vì con trai tôi.
As the snow line retreats further and further up these peaks, there is less and less space for wildlife, and that is a challenge for one of the most majestic of all mountain creatures.	Khi tuyết bắt đầu lùi dần ở những đỉnh này, ngày càng ít dần các khoảng không cho các đời sống hoang dã, và đó là một thách thức cho một trong những điều tráng lệ nhất của hầu hết các sinh vật núi.
The less marijuana and cocaine arriving... less the dealers would gain.	Việc cần sa và cocaine bị vận chuyển hạn chế ít nhất cũng làm giảm số tiền mà bọn buôn kiếm được.
We live in a world in which the boundaries between nations mean less and less, and they will one day mean nothing.	Chúng ta sống trong một thế giới nới mà ranh giới giữa các quốc gia càng ngày càng ít nghĩa hơn và một ngày nào đó chúng sẽ chẳng còn có ý nghĩa.
Experts believe by fiddling with the web's registry of domain names, the result will be less security, and less stability.	Chuyên gia tin rằng việc va chạm tầm phào với đăng kí tên miền web sẽ dẫn đến kém bảo mật và ổn định.
The poor borrow more, save less, smoke more, exercise less, drink more and eat less healthfully.	Người nghèo mượn nhiều, tiết kiệm ít, hút thuốc nhiều, thể dục ít, uống nhiều, và ăn kém khỏe mạnh.
It will also lower your max CPC if it determines a conversion isn't likely, so you'll pay less for clicks that are less likely to convert.	ECPC cũng sẽ giảm CPC tối đa của bạn nếu ECPC xác định một chuyển đổi không có khả năng, do đó, bạn sẽ trả ít hơn cho các nhấp chuột có ít khả năng chuyển đổi hơn.
My motto was the less medicine, the less defective.	Phương châm của tôi là càng sử dụng thuốc ít hơn, khiếm khuyết gây ra sẽ càng ít hơn.
As I got older, though, I read the little pink book less and less, since it was designed mainly for children.	Tuy nhiên, càng lớn hơn tôi càng ít đọc quyển sách nhỏ màu hồng ấy vì hầu như nó chỉ dành cho con trẻ.
Apple also chose to highlight the Mac mini 's energy-efficient capabilities ; the desktop draws less than 13 watts of power when idle , or 10 times less power than a typical desktop PC .	Hãng Apple cũng đưa ra tính nổi bật của Mac mini là khả năng tiết kiệm năng lượng , nó chỉ tiêu thụ chưa tới 13 W điện năng khi ở trạng thái rỗi , ít hơn gấp 10 lần so với các máy tính để bàn cùng loại khác .
And particularly, how can it lead to the creation of buildings which consume less energy, create less pollution and are more socially responsible?	và đặc biệt, làm thế nào nó có thể dẫn đến việc tạo ra các toà nhà sử dụng ít năng lượng hơn, gây ít ô nhiễm hơn, và có trách nhiệm công đồng hơn?
For the last 25 years, oil has been playing less and less of a role in global energy systems.	Trong 25 năm vừa qua, dầu mỏ đang mất dần vị thế của mình trong các hệ thống năng lượng tòan cầu.
If the value is less than 100%, the proportion of impressions delivered is currently less than the proportion of time elapsed in the campaign.	Nếu giá trị dưới 100%, tỷ lệ số lần hiển thị đã phân phối hiện nhỏ hơn tỷ lệ thời gian đã trôi qua trong chiến dịch.
If you need to buy a car and/or borrow money to do so , consider buying one that uses less gas and costs less to insure and maintain .	Nếu bạn cần mua xe và // hoặc mượn tiền mua xe , hãy tính toán mua chiếc xe tiết kiệm xăng và ít tốn phí bảo hiểm và bảo trì .
And what happened was that -- more from less -- you can see how much more for how much less.	Và những gì xảy ra đó là -- kiếm nhiều hơn từ cái ít hơn -- bạn có thể thấy bao nhiêu là nhiều từ rất ít.
More information, we have it in spate, but we get less and less to use it, to understand it; to be wise.	Nhiều thông tin, chúng ta có có đống nhưng chúng ta nhận được ít, dùng quá ít để hiểu và để trở lên thông thái.
If innovation is less powerful, invents less great, wonderful things, then growth is going to be even lower than half of history.	Nếu như đổi mới không đạt tới đà đó, chế tạo ra ít những thứ vĩ đại, tuyệt vời thì tăng trưởng kinh tế sẽ còn ít hơn một nửa của lúc trước.
Australians have about a third less heart disease than we do -- less deaths from heart attacks, heart failure, less strokes -- they're generally a healthier bunch.	Người Úc có tỉ lệ mắc bệnh tim ít hơn chúng ta 1/3-- ít ca tử vong vì đau tim ,suy tim hơn, ít những cơn đột quỵ hơn-- nhìn chung họ là những con người khỏe mạnh hơn chúng ta.
Each extra dollar of GDP is buying less and less social progress.	Từng đồng dollar GDP thêm vào đang mua lại càng ít tiến bộ xã hội.
It's just, every day, I think I believe a little less and a little less and a little less.	Chỉ là, mỗi ngày, anh nghĩ lòng tin của anh cứ cạn dần cạn dần cạn dần
And therefore less juice into the task, fewer puzzles solved and less favorable outcomes compared to you folks.	Và vì vậy ít hơn những nỗ lực được đặt vào nhiệm vụ này, càng ít câu đố được giải hơn, kết quả đạt được sẽ càng kém thuận lợi hơn nếu so với các người chơi khác.
We've noticed, in a trend among young Americans, that they read less history and less literature and less material about foreign lands, and they're essentially ahistorical.	Chúng ta đã nhận ra rằng, một xu hướng trong số người Mỹ trẻ, rằng họ ít đọc lịch sử và văn học hơn và ít tài liệu về vùng đất ở nước ngoài, và về cơ bản là họ không hiểu về lịch sử.
19 As human governments near their end, we will not be surprised if they become less and less tolerant of our loyalty to Jehovah and his Kingdom.	19 Khi các hệ thống chính trị của thế gian gần đến hồi kết liễu, chúng ta sẽ không ngạc nhiên nếu họ ngày càng khó chấp nhận sự trung thành của chúng ta với Đức Giê-hô-va và Nước của ngài.
But researchers have found that when people better understand the possible outcomes of an illness, they have less anxiety, greater ability to plan and less trauma for their families.	Nhưng nghiên cứu đã chỉ ra khi người ta hiểu rõ hơn về bệnh tình của họ, họ sẽ ít đau khổ hơn, chuẩn bị chu đáo hơn, và gia đình họ đỡ suy sụp hơn.
Her ovaries have been producing less and less estrogen , inciting physical and emotional changes across her body .	Buồng trứng của người phụ nữ ngày càng tạo ra ít hoóc-môn động dục nữ , tạo nên các thay đổi trong tình cảm và thể chất .
The less I know, the less help I'll be.	Em biết càng ít thì cũng càng ít em có thể giúp anh.
If you want somebody to do less of something, add a punishment and they'll do less of it.	Nếu muốn ai bớt làm việc gì, hãy bổ sung khung hình phạt và họ sẽ bớt làm điều đó.
Some studies suggest that both adults and children who attach a lot of importance to money and material possessions tend to be less happy, less satisfied with life, and less healthy physically than those who are not materialistic.	Theo vài nghiên cứu, những người lớn và trẻ em quá xem trọng tiền bạc, của cải thường ít hạnh phúc và thỏa nguyện hơn, thậm chí sức khỏe cũng yếu hơn so với những người không đặt nặng vấn đề vật chất.
BBM: Well, people of Iran, this is what many of you are going to evolve to want, and we could get there a lot sooner, and you would suffer a lot less trouble from economic sanctions, and we would suffer a lot less fear of the use of military force on our end, and the world would be a better place.	Đúng, người Iran, đây là những gì nhiều người trong số các bạn sẽ tiến hóa để có, và ta có thể đạt đến sớm hơn rất nhiều, và bạn sẽ phải chịu ít rắc rối hơn từ những chế tài xử phạt, và ta sẽ phải chịu đựng ít hơn những nỗi sợ hãi về lực lượng quân đội, và thế giới sẽ trở nên tốt đẹp hơn.
Farming insects for food also has less environmental impact than livestock farms do because insects emit far less greenhouse gas and use up less space, water, and food.	Nuôi trồng côn trùng làm thực phẩm gây ít tác động lên môi trường hơn các nông trại gia súc bởi vì côn trùng thải ra ít khí nhà kính hơn sử dụng ít diện tích, nước và thức ăn hơn.
If you keep adaptive battery on, apps that you use less often will run less while you're not using them.	Nếu bạn luôn bật tính năng pin thích ứng, thì những ứng dụng mà bạn ít sử dụng hơn sẽ chạy ít hơn khi bạn không sử dụng.
And I mean it -- it will make friends with other plants that use less nitrogen, more phosphorus, less potassium.	Và tôi nói nghiêm túc đấy, nó sẽ kết bạn với những cây khác cần ít ni-tơ hơn, nhiều phốt-pho hơn, ít ka-li hơn.
Identifying other benefits for those who have a spiritual outlook on life, MJA says: “Australian studies have found greater marital stability, less alcohol and illicit drug use, lower rates of and more negative attitudes toward suicide, less anxiety and depression, and greater altruism among the religious.”	Cho thấy những lợi ích khác mà những người có quan điểm sống hướng về tâm linh nhận được, tạp chí MJA nói: “Các cuộc nghiên cứu ở Úc cho thấy rằng những người mộ đạo có hôn nhân bền vững hơn, ít nghiện rượu và lạm dụng ma túy hơn, tỉ lệ tự tử thấp và ít nghĩ đến tự tử hơn, ít lo lắng và trầm cảm hơn, có tinh thần vị tha hơn”.
They allow less media in their homes, less distraction, less activity that draws their children away from their home.	Họ cho phép ít hơn những phương tiện truyền thông vào nhà họ, ít sự xao lãng hơn, ít sinh hoạt mà mang con cái của họ ra khỏi nhà.
In less than 200 years, you know, just in a few generations, we've gone from being 200 -- being 100 percent, 95 percent farmers to less than 2 percent of farmers.	Trong ít hơn 200 năm, bạn đã biết, chỉ trong một vài thế hệ, chúng tôi đã đi từ 200 -- 100 phần trăm, 95 phần trăm người nông dân đến ít hơn 2 phần trăm nông dân.
But maybe you've only got snow shoes, in that case you sink into the Higgs snow field, you've got less speed that the skier, less that the speed of light.	Nhưng có lẽ bạn chỉ có giày đi tuyết, trong trường hợp đó bạn bị lún vào trường tuyết Higgs, bạn có tốc độ chậm hơn người trượt tuyết, chậm hơn vận tốc ánh sáng.
If they get less and less happy, that will be bad for Americans.	Nếu họ ngày càng ít cảm thấy hạnh phúc, đó sẽ là chuyện xấu đối với nước Mĩ.
Less meat, less junk, more plants.	Ít thịt, ít quà vặt, nhiều thực vật.
Too much leisure can lull us into doing less and less meaningful activity.	Quá nhiều sự giải trí có thể khiến chúng ta càng ngày càng giảm đi hoạt động có ý nghĩa.
By the end of this year, we'll be able to sequence the three million bits of information in your genome in less than a day and for less than 1,000 euros.	Đến cuối năm nay, chúng ta sẽ có thể giải trình tự của 3 triệu mã thông tin từ bộ gen của mình trong vòng một ngày với giá ít hơn 1 ngàn euro.
In my lab, we recently found that people with minor facial anomalies and disfigurements are regarded as less good, less kind, less intelligent, less competent and less hardworking.	Trong phòng thí nghiệm, chúng tôi phát hiện những khuôn mặt nhỏ dị thường và biến dạng thường bị coi là kém tốt, kém tử tế, kém thông minh, ít giỏi giang và không chăm chỉ.
People did the first sheet, then we asked if they wanted to do another for a little less money, the next sheet for a little bit less, and so on and so forth.	Và sau đó chúng tôi hỏi họ có muốn làm tờ tiếp theo với ít tiền hơn không và tờ giấy tiếp theo cũng với ít tiền hơn, và cứ tiếp tục như vậy.
But what was striking to me over the last several years was that less and less was I going out into the world, and more and more, I was sitting in front of my computer screen.	Nhưng điều làm tôi bất ngờ trong nhiều năm qua là việc tôi đi ra ngoài ngày càng ít đi, và tôi ngồi trước màn hình máy tính ngày càng nhiều hơn.
The result is that there is less coordination than there should be , as well as a smaller and less well-designed stimulus than is optimal .	Kết quả là có ít phối hợp hơn cần có , cũng như nhỏ hơn và chương trình kích thích kinh tế ít toàn diện hơn hơn là tối ưu .
The extra time and expense involved will be repaid in reduced suffering, less time lost to illness, and less money spent on medical bills.	Nếu bỏ ra thời gian và tiền bạc để chăm sóc sức khỏe, bạn sẽ giảm nguy cơ mắc bệnh, ít hao tốn thời gian và chi phí để chữa trị.
Less and less by the second.	Càng lúc càng ít hơn.
We would end up with less regulation and far less pollution at the same time, while helping working-class Americans get ahead.	Kết quả sẽ là vừa ít điều tiết chính phủ vừa ít ô nhiễm hơn, lại vừa giúp giai cấp công nhân Mỹ phát triển.
It tells people, if you can produce energy for less than 35 bucks a barrel, or less than 40 bucks a barrel, or less than 50 bucks a barrel -- let's debate it -- you will have a business.	Nếu có thể sản xuất năng lượng ít hơn 35 đô một thùng, hoặc ít hơn 40 đô, hay ít hơn 50 đô Hãy tranh luận nào- bạn sẽ có một doanh nghiệp.
One observer has written: “In a world that constantly compares people, ranking them as more or less intelligent, more or less attractive, more or less successful, it is not easy to really believe in a [divine] love that does not do the same.	Một người quan sát đã viết: “Trong một thế giới mà luôn so sánh người ta, sắp hạng họ là người thông minh nhiều hay ít, hấp dẫn nhiều hay ít, thành công nhiều hay ít hơn người khác thì không phải là điều dễ dàng để thực sự tin vào một tình yêu thương [thiêng liêng] mà không làm những điều như thế.”
So the message he was giving us was you must get more from less and less and less so that you can share it for more and more people, not only the current generation, but the future generations.	Thế nên bài học mà ông muốn nhắn gửi tới chúng ta đó là bạn phải kiếm nhiều hơn từ cái ít hơn và ít hơn nữa thì bạn mới có thể chia sẻ cho nhiều và nhiều người hơn, không chỉ cho thế hệ hôm nay, mà cho cả những thế hệ tương lai.
If you do this again and again, the propensity, the tendencies for anger to arise again will be less and less each time you dissolve it.	Nếu bạn làm điều này nhiều lần, cái khuynh hướng, xu hướng giận dữ tiếp tục khởi lên sẽ ít dần đi sau mỗi lần bạn làm nó tan biến.
like you're less than, less than perfect pretty pretty please if you ever ever feel	Này người đẹp xinh ơi, nếu em có bao giờ cảm thấy như em không là gì cả. Nhớ rằng em thật hoàn hảo với tôi.
The interesting thing is that intuitive eaters are less likely to be overweight, and they spend less time thinking about food.	Điều thú vị là người ăn kiêng theo trực giác ít có khả năng bị béo phì, và họ dành ít thời gian nghĩ tới thức ăn hơn.
The person who knows the birds in his own neighborhood will be much better prepared for a trip to some other place to find less common or less visible birds.	Có được kiến thức về các loại chim trong vùng phụ cận của mình sẽ giúp chuẩn bị tốt hơn cho một chuyến đi đến nơi khác để tìm các loại chim hiếm và khó thấy.
Misunderstanding God’s justice and mercy is one thing; denying God’s existence or supremacy is another, but either will result in our achieving less—sometimes far less—than our full, divine potential.	Hiểu lầm về công lý và lòng thương xót của Thượng Đế là một chuyện; phủ nhận sự hiện hữu hay thẩm quyền và quyền năng tối cao của Thượng Đế là một chuyện khác, nhưng cả hai đều dẫn đến việc chúng ta đạt được ít hơn—đôi khi còn ít hơn nhiều—so với tiềm năng trọn vẹn và thiêng liêng của mình.
So, when you eat less fat, you eat fewer calories without having to eat less food.	Nên khi bạn ăn ít chất béo hơn, bạn nạp ít năng lượng hơn mà không ăn ít đi.
We in public health, we hate child death, so we want less and less and less of child deaths.	Chúng tôi làm trong ngành y tế cộng đồng, chúng tôi ghét trẻ em tử vong, nên chúng tôi muốn tỷ lệ đó giảm càng nhiều càng tốt.
If you want to work less, your employer may expect you to accept less compensation.	Nếu bạn muốn làm ít giờ hơn, có thể chủ sẽ cắt giảm lương của bạn.
- has any signs of dehydration ( urinating less than usual , not having tears when crying , less alert and less active than usual )	- có bất kỳ dấu hiệu nào của triệu chứng mất nước ( đi tiểu ít hơn bình thường , khóc không có nước mắt , kém tươi tỉnh và kém hoạt bát như thường lệ )
It can result in an unbalanced life with less and less time for spiritual activities. —1 Timothy 6:9, 10; The Jerusalem Bible.	Hậu quả có thể là đời sống thiếu thăng bằng và càng ngày càng ít thì giờ cho những hoạt động thiêng liêng (I Ti-mô-thê 6:9, 10; bản dịch Nguyễn Thế Thuấn).
1 And it came to pass that thus passed away the ninety and fifth year also, and the people began to forget those asigns and wonders which they had heard, and began to be less and less astonished at a sign or a wonder from heaven, insomuch that they began to be hard in their hearts, and blind in their minds, and began to disbelieve all which they had heard and seen—	1 Và chuyện rằng, như vậy là năm thứ chín mươi lăm cũng trôi qua, và dân chúng bắt đầu quên những điềm triệu và những điều kỳ diệu mà họ đã được nghe, và họ cũng bắt đầu bớt ngạc nhiên về điềm triệu và điều kỳ diệu trên trời, đến nỗi họ bắt đầu chai đá trong lòng và mù quáng trong trí, và bắt đầu không tin tất cả những gì họ đã được nghe và thấy—
And he abandoned the rope and the use of his bare hands which makes his kills less personal and less controlling.	Và hắn bỏ sợi dây thừng và sử dụng bàn tay trần của mình mà làm cho thú giết người ít cá nhân và ít kiểm soát.
Historians report that during this period, many Gentiles “attached themselves more or less closely to Jewish communities, took part in the Jewish divine service and observed Jewish precepts sometimes more, sometimes less completely.” —The History of the Jewish People in the Age of Jesus Christ.	Các sử gia tường thuật rằng trong giai đoạn ấy, nhiều người thuộc dân ngoại “không ít thì nhiều cũng giao tiếp với cộng đồng người Do Thái, tham gia việc thờ phượng và giữ theo luật pháp của dân này, theo sát tất cả hoặc chỉ một phần luật pháp ấy”. —Lịch sử của dân Do Thái trong thời Giê-su Christ (The History of the Jewish People in the Age of Jesus Christ).
Depravity becomes more and more tolerable because less and less scandalizes us.”—Compare 1 Timothy 4:1, 2.	Sự đồi bại càng ngày càng trở nên dễ dung túng hơn vì nó càng ngày càng ít làm cho chúng ta kinh hãi”. (So sánh I Ti-mô-thê 4:1, 2).
We, the crew, can and must do more with less -- much less."	Chúng tôi, phi hành đoàn có thể và phải làm nhiều việc với ít thứ --rất ít."
He says one reason is that since the end of the Cold War , European nations have been accommodating American interests less and less because they don't need Washington as much as they did during the Soviet threat .	Ông đưa ra lý do là khi chiến tranh lạnh kết thúc , các quốc gia châu Âu không còn mang đến nhiều lợi ích cho Hoa Kỳ vì họ không còn cần đến Washington nhiều như tại thời điểm bị chính quyền Soviet đe doạ .
" If your child talks to you less and less about the things that matter , this could be a sign that you are too strict , " Taffel says .	Theo Taffel , " Nếu trẻ ngày càng nói chuyện với bạn ít dần về những điều quan trọng thì có lẽ đây là dấu hiệu cho thấy bạn quá khắt khe với con " .
They are posh, they're wealthy, they're less likely to have outdoor jobs, they're less likely to do manual labor, they have better social support, they're less likely to smoke -- so for a whole host of fascinating, interlocking social, political and cultural reasons, they are less likely to have skin wrinkles.	Họ là người bề trên, họ giàu có, có thể họ ít làm việc ở bên ngoài hơn, có thể họ ít phải lao động tay chân hơn, họ có trợ cấp xã hội tốt hơn, có thể họ ít hút thuốc hơn như vậy, vì một loạt những lý do đan xen về văn hóa, chính trị, xã hội, họ có thể có ít nếp nhăn hơn.
You will tend to do smaller work on smaller stages, your economic power will be less, your reach of audiences will be less, and your credit will be less as an artist.	Bạn sẽ có xu hướng làm công việc nhỏ hơn ở những sân khấu nhỏ hơn, Sức mạnh kinh tế của bạn sẽ nhỏ hơn, phạm vi khán giả của bạn cũng sẽ nhỏ đi, và danh tiếng của bạn cũng sẽ thấp hơn.
Vertical farming uses 10 times less water and a hundred times less land than conventional farming.	Trồng rau trên giá cần ít nước hơn 10 lần ít đất lơn 100 lần so với cách trồng bình thường.
If the US had not invested in its schools and in its skills a century ago with the high school movement, we would be a less prosperous, a less mobile and probably a lot less happy society.	Nếu Mỹ đã không đầu tư vào trường học và kĩ năng một thế kỷ trước với sự dịch chuyển trung học, ta đã trở thành một xã hội ít thịnh vượng, ít năng động và ít hạnh phúc nhiều lần rồi.
(Genesis 11:1-9) With their innate sense of the divine, humans sought to draw close to God, with whom they were less and less familiar, ‘groping’ for him blindly.	(Sáng-thế Ký 11:1-9) Với khuynh hướng thờ phượng bẩm sinh, loài người tìm cách đến gần Đức Chúa Trời, Đấng mà họ ngày càng xa lạ, “rờ tìm” như người mù.
3 Although the congregation now meets together on one less occasion a week, this does not mean that publishers should receive less shepherding.	3 Dù hiện nay hội thánh chỉ nhóm họp hai lần một tuần, điều này không có nghĩa là người công bố được chăm nom ít hơn.
So actually we are getting less from more for less and less people.	Thế là thực chất chúng ta đang kiếm được ít hơn từ cái nhiều hơn cho ít và ít người hơn.
Facts become less and less important to her as she grows older.	Bà ấy càng già đi, thì sự thật càng ngày càng trở nên ít quan trọng với bà ấy.
Bada bing bada beam, sigma t to the fourth, we can compute the radius of Sirius B, and the radius of Sirius B turns out to be less than a percent of the solar radius, more impressively, less than	Bada bing bada chùm, sigma t để các Thứ tư, chúng tôi có thể tính toán bán kính của Sirius B, và bán kính của Sirius B quay ra là ít hơn một phần trăm của bán kính mặt trời, Ấn tượng hơn, ít hơn
Outside of this room, more than a third of us smile more than 20 times per day, whereas less than 14 percent of us smile less than five.	Và ở ngoài khán phòng này hơn một phần ba dân số thế giới cười hơn 20 lần một ngày, và có dưới 14% dân số thế giới cười ít hơn 5 lần một ngày.
We've got to be doing things with more efficiency using less energy, less material.	Chúng ta đã làm được nhiều thứ hiệu quả, ít năng lượng hơn, vật liệu hơn.
Is less than 3C. So it means your value of going to see your parents is less than tree times the cost of going to the airport.	Hay nói cách khác, giá trị của việc gặp cha mẹ nhỏ hơn 3 lần chi phí đi lại đến sân bay
Less and less, every time I see you.	Càng ngày tôi càng ít thấy cô.
I think that the circumstances are different and that there was conscription in the civil war there is no draft today and I think that the volunteers for the army today have a more profound sense of patriotism that is of an individual choice than those who were forced into the military in the civil war somehow less coerced. less coerced. even though there is still inequality in American society even though as Emily points out the make- up of the American military is not reflective of the population as a whole.	Vì vậy, những gì bạn sẽ nói cho rằng đối số? Tôi nghĩ rằng có những hoàn cảnh khác nhau và đã có sự bắt buộc ở cuộc nội chiến có là không có dự thảo ngày hôm nay và tôi nghĩ rằng các tình nguyện viên cho quân đội vào ngày hôm nay có một ý nghĩa sâu sắc hơn của tinh thần yêu nước đó là một sự lựa chọn cá nhân so với những người bị buộc phải quân sự trong cuộc nội chiến bằng cách nào đó ít ép. ít ép. mặc dù đó là vẫn còn bất bình đẳng trong xã hội Mỹ mặc dù như Emily chỉ ra Các make- up của quân đội Mỹ không phải là phản chiếu của dân số như một toàn thể.
Water cannot be drawn from an empty well, and if you are not setting aside a little time for what replenishes you, you will have less and less to give to others, even to your children.	Nước không thể múc ra từ một cái giếng khô, và nếu các chị em không dành ra một thời gian ngắn cho những gì mà làm cho cuộc sống của các chị em tràn đầy, thì các chị em sẽ càng có ít hơn để ban phát cho những người khác, ngay cả con cái của các chị em.
They will become less sensitive to criticism, less inclined to take offense.	Họ sẽ ít nhạy cảm hơn với sự chỉ trích và không dễ bị tổn thương.
We try and do more and more with less and less time.	Cố làm nhiều hơn với ít thời gian hơn.
A less equitable, less secure world, and growing violence, are the realities.	Một thế giới ít công bình hơn, an ninh kém hơn và sự hung bạo gia tăng là những thực tại phũ phàng.
We spent a lot less on education, about 35 percent less on education.	Chi cho giáo dục lúc đó ít hơn nhiều, ít hơn khoảng 35 phần trăm.
And then the other areas become less and less positive.	Và sau đó là những vùng khác dần ít tích cực hơn.
Well, the less demon I was, the less the cuffs worked.	Anh càng ít phần quỷ bao nhiêu, cái còng càng ít hiệu quả bấy nhiêu.
Gradually, the government became less and less tolerant of religion.	Chính quyền ngày càng khắt khe hơn đối với tôn giáo.
But an association: The higher people's blood levels of vitamin D are, the less heart disease they have, the less cancer.	Nhưng có một mối liên hệ: nồng độ vitamin D trong máu của con người càng cao, họ càng ít bị bệnh tim mạch và ung thư.
You lose your sense of balance, you get muscle tremors, and that tends to lead people to being less and less mobile.	Bạn sẽ mất cảm giác cân bằng, bạn sẽ bị run cơ, và điều đó dần làm cho người ta ngày càng ngại di chuyển.
The house-to-house work can thus become less daunting and workmates less intimidating, while whole-souled service becomes more appealing. —Isaiah 51:12; Romans 10:10.	Như thế, công việc rao giảng từ nhà này sang nhà kia có thể trở nên ít thoái chí và họ càng thấy ít sợ những bạn cùng sở, trong khi đó việc phụng sự hết mình càng trở nên thích thú hơn (Ê-sai 51:12; Rô-ma 10:10).
Be careful not to take it for granted, only to find that you gradually speak with each other less and less.	Hãy tránh coi thường sự thông tri giữa vợ chồng, nếu không vợ chồng sẽ càng ngày càng ít nói chuyện với nhau.
So one question to keep in mind as you're doing this first page is: Has anyone else in the history of time less intelligent or less driven figured this out?	Có một câu hỏi cần lưu ý khi bạn làm trang đầu tiên này là: Xưa nay, đã từng có ai khác ít thông minh hơn hoặc ít định hướng hơn từng xử lý được nó chưa?
And it's this long-term kind of procrastination that's much less visible and much less talked about than the funnier, short-term deadline-based kind.	Và chính sự trì hoãn dài hạn này không dễ bị phát hiện và ít được nói đến hơn cái trì hoãn vì ham vui ngắn hạn, và có thời hạn.
But even for those of us who have experienced this before, it is no less of a shock, it is no less terrifying.	Nhưng dù đối với những người đã từng trải qua chuyện này, nó không hề ít sốc hơn, không hề ít đáng sợ hơn.
Less mysterious —but no less tragic— are the bodies of children who were sacrificed as offerings to the Andes mountain gods.	Ít huyền bí hơn nhưng không kém phần bi thảm, đó là những thi hài của trẻ con bị tế các thần núi Andes.
It turns out, most people over 50 feel better, are less stressed, less hostile, less anxious.	Hóa ra, phần lớn người trên 50 tuổi đều cảm thấy tốt hơn, ít bị căng thăng hơn ít thù hằn và lo lắng hơn.
It feels less positive, less optimistic, to talk about how the pie is sliced than to think about how to make the pie bigger.	Nó khiến ta cảm thấy ít tích cực, ít lạc quan hơn để nói về chuyện làm thế nào chiếc bánh được phân chia hơn là để suy nghĩ về việc làm thế nào làm cho chiếc bánh lớn hơn.
“Among married individuals, premarital cohabitation is related to lower marital satisfaction, less time spent together in shared activities, higher levels of marital disagreement, less supportive behavior, less positive problem solving, [and] more reports of marital problems . . .	“Trong số các cặp sống thử nay đã kết hôn, việc sống thử có liên quan đến tình trạng hôn nhân không mấy thỏa nguyện, ít dành thời gian sinh hoạt chung, có nhiều bất đồng hơn, ít ủng hộ nhau, ít thành công trong việc giải quyết các vấn đề, [và] có nhiều báo cáo hơn về các vấn đề trong hôn nhân...
We have more and more time-saving devices, but sometimes, it seems, less and less time.	Ngày càng nhiều thiết bị tiết kiệm thời gian ra đời, nhưng có vẻ như, thời gian ngày càng thu hẹp lại.
And my laptop runs slower, less reliably and less pleasantly than it ever has before.	Máy tính của tôi chạy chậm hơn, kém ổn định hơn, và thêm phần khó chịu hơn trước.
As children grow up, parents may feel less and less responsibility toward them.	Khi con cái khôn lớn thì cha mẹ thường cảm thấy càng có ít trách nhiệm hơn đối với chúng.
I thought it would be less- - less messy.	Thần nghĩ là nó sẽ đỡ - ít dơ bẩn hơn.
From field studies to laboratory studies, we see that winning or losing an election, gaining or losing a romantic partner, getting or not getting a promotion, passing or not passing a college test, on and on, have far less impact, less intensity and much less duration than people expect them to have.	Từ các nghiên cứu thực địa cho đến những nghiên cứu trong phòng thí nghiệm, chúng ta thấy rằng thắng hay thua một cuộc bầu cử, có được hay bị mất đi người yêu, được hoặc không được thăng chức, đỗ hay trượt một kì thi đại học, v. v., có tác động, cường độ và đặc biệt là thời gian diễn ra ít hơn rất nhiều so với chúng ta nghĩ.
These initiatives cost less than a missile, and certainly less than any soldier's life, but more importantly, it takes the war to their homelands, and not onto our shore, and we're looking at the causes.	Những ý tưởng này không đắt bằng 1 tên lửa, và chắc chắn không bằng mạng sống của bất kì người lính nào, nhưng quan trọng hơn, nó đưa chiến tranh về quê hương của nó mà không phải vào bờ biển của chúng ta, và ta nhìn vào những nguyên nhân.
Uh... did people get less surprising or are we less easily surprised?	Bây giờ người ta ít tạo được bất ngờ hay chúng ta không còn cảm thấy bất ngờ?
But after the buzz, the excitement, the power that comes from this community, I began to yearn for a less sterile, less academic way to address these issues, the issues that I was talking about.	Nhưng sau sự phấn khích, sức mạnh đã tới từ cộng đồng này, Tôi bắt đầu mong muốn tìm ra một cách ít khô khan, ít học thuật hơn, để giải quyết vấn đề, vấn đề mà tôi đã nói.
You and I should think less about ourselves, think more about other people talk less and do more expect less and give more and that's all for my talk thank you for listening	Bạn và tôi nên nghĩ ít hơn về bản thân, mà hãy nghĩ nhiều hơn về những con người khác nói ít mà làm nhiều kì vọng ít đi và cho đi nhiều hơn và đó là tất cả những gì tôi muốn nói cảm ơn các bạn đã lắng nghe �
She's got less and less control over her magic lately.	Gần đây con bé càng lúc càng mất kiểm soát phép thuật của mình.
So, if you put it all together, this could help explain why today's college graduates, as well as less educated Americans, know less about the world than their counterparts did 20 years ago.	Và nếu bạn đặt mọi thứ với nhau, nó có thể giải thích tại sao ngày nay một sinh viên đại học cũng như những người Mỹ ở bậc học thấp hơn biết về thế giới ít hơn so với 20 năm trước
You could've made this less painful if you had been more concerned about my daughter and less concerned about your goddamn desk.	Anh đã có thể không gây ra sự đau đớn này nếu như có chút quan tâm tới con gái tôi hơn là cái bàn giấy chết tiệt của anh
And what they've realized is that using violence in the situations they operate in is not only less humane, but it's less effective than using methods that connect people with people, that rebuild.	Và họ nhận ra rằng sử dụng bạo lực trong những trường hợp trên không chỉ là phi nhân đạo, mà còn không hiệu quả bằng những phương pháp kết nối con người lại với nhau.
The typical Portland citizen drives four miles less, and 11 minutes less per day than they did before.	Một công dân Portland điển hình lái giảm đi bốn dặm, và ngắn đi 11 phút một ngày so với trước đây.
And so I began to feel myself doing less and thinking less and feeling less.	Và rồi tôi bắt đầu thấy mình hoạt động ít dần suy nghĩ ít dần cảm nhận ít dần.
So it turns out that being paid less and praised less has its upsides -- for society at least.	Hóa ra được trả ít hơn và được khen ít hơn có những mặt tích cực của riêng nó --- ít nhất là cho xã hội.
* China’s growth pattern is also changing as it moves up the income ladder, and is likely to rely more on consumption and less on investment and exports, and more on services and less on industry – offering opportunities and challenges.	* Mô hình tăng trưởng của Trung Quốc cũng đang thay đổi khi quốc gia này gia nhập nhóm nước thu nhập cao hơn, và Trung Quốc có thể sẽ tăng cường tiêu thụ nội địa và giảm phụ thuộc vào đầu tư và xuất khẩu, tăng cường dịch vụ và giảm công nghiệp. Điều này mang lại cả cơ hội và thách thức.
And therefore less juice into the task, fewer puzzles solved and less favorable outcomes compared to you folks.	làm giảm đi sự tự tin khi bạn thực hiện hành động, mà ở đây nghĩa là giải đáp các câu đố.
In a world where media is global, social, ubiquitous and cheap, in a world of media where the former audience are now increasingly full participants, in that world, media is less and less often about crafting a single message to be consumed by individuals.	trong thế giới mà truyền thông là tòan cầu, xã hội, khắp nơi và rẻ tiền nơi mà những khán giả đầu tiên đang tăng tính đóng góp trong thế giới truyền thông ngày càng ít gửi đi thông điệp đơn lẻ đến một cá nhân
As the responsibilities of my job increased, I spent less and less time in the ministry.	Trách nhiệm ngày càng nặng nề khiến tôi càng có ít thời giờ cho thánh chức.
The less you kill, the less better you feel.	Càng giết ít, càng thấy ít tốt hơn.
When you relieve the suffering of others, you will feel happier, more optimistic, less lonely, and less inclined to think negative thoughts.	Khi xoa dịu nỗi đau của người khác, chúng ta sẽ hạnh phúc và lạc quan hơn, bớt cô đơn và ít nghĩ tiêu cực hơn.
The sight of a woman playing drums enfeebles her, makes her less feminine, less desirable, but all this optimally puts her on a lower social stand.	Hình ảnh một người phụ nữ chơi trống làm cô ấy trở nên yếu ớt, kém nữ tính, kém quyến rũ, nhưng tất cả những điều này, hơn hết, đẩy cô ấy vào vị thế thấp kém hơn.
I asked President Tanner why the roads and highways in western Canada basically remained intact during such winters, showing little or no signs of cracking or breaking, while the road surfaces in many areas where winters are less cold and less severe developed cracks and breaks and potholes.	Tôi hỏi Chủ Tịch Tanner lý do tại sao những con đường và xa lộ ở miền tây Gia Nã Đại hầu như không bị ảnh hưởng gì trong những mùa đông như thế, chỉ cho thấy rất ít hay không hề có dấu hiệu nứt hay vỡ lở gì hết, trong khi đó mặt đường ở nhiều khu vực mà mùa đông ít lạnh hơn và ít khắc nghiệt hơn lại sinh ra các chỗ nứt, các chỗ lở và những cái ổ gà.
Why less and less people?	Tại sao lại ít và ít người hơn?
The old games are proving less and less effective.	Các chiêu trò cũ ngày càng kém hiệu quả.
